NO textures/a.png
dsfdsf
SO textures/b.png  
WE textures/c.png
EA textures/d.png

F 255,100,0
C 225,30,0


111111
100101
10N001
11000001
111111