NO textures/a.png

SO textures/b.png
WE textures/bluewall.png
F 192,247,176
C 152,169,217
EA textures/d.png

1111111111111111111111111111111111111111111111111111
        1000000000110000000000001000000000000000000000000001
        10110000011100000000000010000000000000000000000000000000001
        100100000000000000000000100000000000000000000000000001
111111111011000001110000000000001000000000000000000000000001
10000000001100000111011111111111100000000000000000000000000000000001
1111011111111101110000001000100000000000000000000000000001
111101111111110111010100100010000000000000000000000000000001
11000000110101011100000010001000000000000000000000000000000001
10000000000000000000000000000000000000000000000000001
1000N0000000000011010100000000000000000000000000000000000001
110000011101010101110111100011100000000000000000000000000000001
10000111 111010111011110100010000000000000000000000000000000001
 1111111 1111111 1111111110000000000000000000000000000000000000001